11111111
1E001P01
11000001
10C00001
10000001
10000C01
11111111